111111111111111111111111111111
1P0E01000000000000000000000001
100001000111111111111111111001
100000000110001000100010001001
111111111100100010001000100001
100000000000111111111111111111
101111100100000000000000000001
100000000100001100000000011001
100000000100000111000000011001
100111111110000001110011111001
100000000100000000011110C11101
100000011100000001110011000101
10000C010000000011000001110001
100000010000001110011100011111
100011111110011000010000000001
100000000000001100011111110001
100000000000000111000000C10001
1000A0000000000001111111111001
1000000000000A0000000000000001
111111111111111111111111111111
